15,15,15,15,15,15,15,15,15,15,15,15
15,16,3,7,16,3,3,3,3,3,1,15
15,16,8,8,16,8,8,16,16,16,16,15
15,0,8,3,3,5,5,6,16,16,3,15
15,8,8,16,16,16,3,16,16,16,8,15
15,8,7,3,3,5,16,3,16,16,8,15
15,8,3,16,16,16,5,8,16,16,8,15
15,8,3,16,16,3,3,8,16,16,8,15
15,3,3,16,16,8,8,3,16,16,8,15
15,3,8,8,8,8,8,8,8,8,8,15
15,16,16,16,16,16,16,16,16,16,16,15
15,15,15,15,15,15,15,15,15,15,15,15
